key	text	tooltip
#Loc;1;text/db/rhox_torinubar_dilemma.loc		
dilemmas_localised_description_rhox_torinubar_dilemma_cth_caravan_1A	Spend gold to access an ancient chart promising a quicker route, or continue cautiously along known waters.	false
dilemmas_localised_description_rhox_torinubar_dilemma_cth_caravan_1B	Pay a toll to skilled starlit navigators for a swifter course, or stick to established maps and conserve gold.	false
dilemmas_localised_description_rhox_torinubar_dilemma_cth_caravan_2A	An enigmatic mist engulfs your convoy, revealing an ancient shrine. The path branches, presenting a choice.	false
dilemmas_localised_description_rhox_torinubar_dilemma_cth_caravan_2B	Melodic whispers waft across the waves, leading to a hidden lagoon. Two distinct paths unfurl before you.	false
dilemmas_localised_description_rhox_torinubar_dilemma_cth_caravan_3A	Fellow High Elves, skilled in seafaring, request to join your maritime endeavors and contribute their expertise.	false
dilemmas_localised_description_rhox_torinubar_dilemma_cth_caravan_3B	A group of skilled High Elf sailors seeks to merge their journey with yours, under a mutual agreement.	false
dilemmas_localised_description_rhox_torinubar_dilemma_cth_caravan_4A	An experienced group of High Elf warriors offers their aid to your convoy, pledging to enhance your crew's combat prowess.	false
dilemmas_localised_description_rhox_torinubar_dilemma_cth_caravan_4B	Phoenix king decided to send a reinforcement to this convoy. What kind of reinforcement do you want?	false
dilemmas_localised_description_rhox_torinubar_dilemma_cth_caravan_battle_1A	A notorious pirate ship emerges from the mist, its captain demanding tribute or the promise of violence.	false
dilemmas_localised_description_rhox_torinubar_dilemma_cth_caravan_battle_1B	A corsair ship sails alongside, its captain issuing an ultimatum: Surrender cargo or face imminent assault.	false
dilemmas_localised_description_rhox_torinubar_dilemma_cth_caravan_battle_2A	A menacing pirate ship looms ahead, blocking your path. The choice before you is clear, but not without risk.	false
dilemmas_localised_description_rhox_torinubar_dilemma_cth_caravan_battle_2B	The silhouette of a pirate vessel emerges on the horizon. A decision must be made swiftly to ensure your convoy's fate.	false
dilemmas_localised_description_rhox_torinubar_dilemma_cth_caravan_battle_3	A notorious pirate ship looms ahead, its ominous presence undeniable. A chilling message arrives from the pirate captain, revealing an unexpected connection.	false
dilemmas_localised_title_rhox_torinubar_dilemma_cth_caravan_1A	Convoy Encounter: Swift Currents	false
dilemmas_localised_title_rhox_torinubar_dilemma_cth_caravan_1B	Convoy Encounter: Starlit Navigators	false
dilemmas_localised_title_rhox_torinubar_dilemma_cth_caravan_2A	Convoy Encounter: Seaborne Blessing	false
dilemmas_localised_title_rhox_torinubar_dilemma_cth_caravan_2B	Convoy Encounter: Whispering Tides	false
dilemmas_localised_title_rhox_torinubar_dilemma_cth_caravan_3A	Convoy Encounter: Allies on the Waves	false
dilemmas_localised_title_rhox_torinubar_dilemma_cth_caravan_3B	Convoy Encounter: Pact of Tides and Gold	false
dilemmas_localised_title_rhox_torinubar_dilemma_cth_caravan_4A	Convoy Encounter: Martial Reinforcements	false
dilemmas_localised_title_rhox_torinubar_dilemma_cth_caravan_4B	Convoy Encounter: Elite Sailors of Ulthuan	false
dilemmas_localised_title_rhox_torinubar_dilemma_cth_caravan_battle_1A	Convoy Encounter: Shadowed Plunderer	false
dilemmas_localised_title_rhox_torinubar_dilemma_cth_caravan_battle_1B	Convoy Encounter: Corsair's Ultimatum	false
dilemmas_localised_title_rhox_torinubar_dilemma_cth_caravan_battle_2A	Convoy Encounter: Clash of Currents	false
dilemmas_localised_title_rhox_torinubar_dilemma_cth_caravan_battle_2B	Convoy Encounter: Veiled Evade	false
dilemmas_localised_title_rhox_torinubar_dilemma_cth_caravan_battle_3	Convoy Encounter: Old Nemesis	false
cdir_events_dilemma_choice_details_localised_choice_label_rhox_torinubar_dilemma_cth_caravan_1AFIRST	Opt for the familiar path	false
cdir_events_dilemma_choice_details_localised_choice_label_rhox_torinubar_dilemma_cth_caravan_1ASECOND	Invest gold in the ancient chart	false
cdir_events_dilemma_choice_details_localised_choice_label_rhox_torinubar_dilemma_cth_caravan_1BFIRST	Decline the offer	false
cdir_events_dilemma_choice_details_localised_choice_label_rhox_torinubar_dilemma_cth_caravan_1BSECOND	Pay the navigators' toll 	false
cdir_events_dilemma_choice_details_localised_choice_label_rhox_torinubar_dilemma_cth_caravan_2AFIRST	Loot the Shrine	false
cdir_events_dilemma_choice_details_localised_choice_label_rhox_torinubar_dilemma_cth_caravan_2ASECOND	Seek for its blessing	false
cdir_events_dilemma_choice_details_localised_choice_label_rhox_torinubar_dilemma_cth_caravan_2BFIRST	Rest at the lagoon	false
cdir_events_dilemma_choice_details_localised_choice_label_rhox_torinubar_dilemma_cth_caravan_2BSECOND	Anchor at the lagoon and explore its depths	false
cdir_events_dilemma_choice_details_localised_choice_label_rhox_torinubar_dilemma_cth_caravan_3AFIRST	No thank you	false
cdir_events_dilemma_choice_details_localised_choice_label_rhox_torinubar_dilemma_cth_caravan_3ASECOND	Accept their offer 	false
cdir_events_dilemma_choice_details_localised_choice_label_rhox_torinubar_dilemma_cth_caravan_3BFIRST	Kindly decline their request	false
cdir_events_dilemma_choice_details_localised_choice_label_rhox_torinubar_dilemma_cth_caravan_3BSECOND	Agree to their proposal and offer a sum of gold	false
cdir_events_dilemma_choice_details_localised_choice_label_rhox_torinubar_dilemma_cth_caravan_4AFIRST	Accept their offer of ranged units	false
cdir_events_dilemma_choice_details_localised_choice_label_rhox_torinubar_dilemma_cth_caravan_4ASECOND	Accept their offer of melee units	false
cdir_events_dilemma_choice_details_localised_choice_label_rhox_torinubar_dilemma_cth_caravan_4BFIRST	Choose the melee focused sailors.	false
cdir_events_dilemma_choice_details_localised_choice_label_rhox_torinubar_dilemma_cth_caravan_4BSECOND	Choose the range focused sailors.	false
cdir_events_dilemma_choice_details_localised_choice_label_rhox_torinubar_dilemma_cth_caravan_battle_1AFIRST	Defend your cargo and crew	false
cdir_events_dilemma_choice_details_localised_choice_label_rhox_torinubar_dilemma_cth_caravan_battle_1ASECOND	Yield a portion of your cargo as tribute	false
cdir_events_dilemma_choice_details_localised_choice_label_rhox_torinubar_dilemma_cth_caravan_battle_1BFIRST	Stand firm against the pirates	false
cdir_events_dilemma_choice_details_localised_choice_label_rhox_torinubar_dilemma_cth_caravan_battle_1BSECOND	Reluctantly relinquish a share of your cargo to avoid conflict.	false
cdir_events_dilemma_choice_details_localised_choice_label_rhox_torinubar_dilemma_cth_caravan_battle_2AFIRST	Confront the pirate ship head-on	false
cdir_events_dilemma_choice_details_localised_choice_label_rhox_torinubar_dilemma_cth_caravan_battle_2ASECOND	Opt for a lengthy detour	false
cdir_events_dilemma_choice_details_localised_choice_label_rhox_torinubar_dilemma_cth_caravan_battle_2BFIRST	Steer towards the pirate ship	false
cdir_events_dilemma_choice_details_localised_choice_label_rhox_torinubar_dilemma_cth_caravan_battle_2BSECOND	Evade the pirates	false
cdir_events_dilemma_choice_details_localised_choice_label_rhox_torinubar_dilemma_cth_caravan_battle_3FIRST	Reject the pirate captain's demand	false
cdir_events_dilemma_choice_details_localised_choice_label_rhox_torinubar_dilemma_cth_caravan_battle_3SECOND	Sacrifice the crew member 	false
cdir_events_dilemma_choice_details_localised_choice_title_rhox_torinubar_dilemma_cth_caravan_1AFIRST	Opt for the familiar path, conserving resources and navigating with prudence.	false
cdir_events_dilemma_choice_details_localised_choice_title_rhox_torinubar_dilemma_cth_caravan_1ASECOND	Invest gold in the ancient chart, embracing the risk for potential swifter travel.	false
cdir_events_dilemma_choice_details_localised_choice_title_rhox_torinubar_dilemma_cth_caravan_1BFIRST	Decline the offer, preserving your funds and navigating through known routes, albeit at a potentially slower pace.	false
cdir_events_dilemma_choice_details_localised_choice_title_rhox_torinubar_dilemma_cth_caravan_1BSECOND	Pay the navigators' toll for guided navigation, trusting in their expertise for a faster journey.	false
cdir_events_dilemma_choice_details_localised_choice_title_rhox_torinubar_dilemma_cth_caravan_2AFIRST	Uncover forgotten High Elf relics and secure valuable cargo.	false
cdir_events_dilemma_choice_details_localised_choice_title_rhox_torinubar_dilemma_cth_caravan_2ASECOND	Mysterious energies subtly mend your ship and crew, ensuring their well-being.	false
cdir_events_dilemma_choice_details_localised_choice_title_rhox_torinubar_dilemma_cth_caravan_2BFIRST	Gentle breezes from the lagoon grant your crew revitalizing reprieve, offering healing.	false
cdir_events_dilemma_choice_details_localised_choice_title_rhox_torinubar_dilemma_cth_caravan_2BSECOND	Recover forgotten treasures and rare cargo concealed beneath its waters.	false
cdir_events_dilemma_choice_details_localised_choice_title_rhox_torinubar_dilemma_cth_caravan_3AFIRST	I don't like the idea	false
cdir_events_dilemma_choice_details_localised_choice_title_rhox_torinubar_dilemma_cth_caravan_3ASECOND	Welcome abroad	false
cdir_events_dilemma_choice_details_localised_choice_title_rhox_torinubar_dilemma_cth_caravan_3BFIRST	The High Elves appreciate your understanding	false
cdir_events_dilemma_choice_details_localised_choice_title_rhox_torinubar_dilemma_cth_caravan_3BSECOND	The High Elf sailors join your convoy	false
cdir_events_dilemma_choice_details_localised_choice_title_rhox_torinubar_dilemma_cth_caravan_4AFIRST	Accept their offer of ranged units	false
cdir_events_dilemma_choice_details_localised_choice_title_rhox_torinubar_dilemma_cth_caravan_4ASECOND	Accept their offer of melee units	false
cdir_events_dilemma_choice_details_localised_choice_title_rhox_torinubar_dilemma_cth_caravan_4BFIRST	Choose the melee focused sailors.	false
cdir_events_dilemma_choice_details_localised_choice_title_rhox_torinubar_dilemma_cth_caravan_4BSECOND	Choose the range focused sailors.	false
cdir_events_dilemma_choice_details_localised_choice_title_rhox_torinubar_dilemma_cth_caravan_battle_1AFIRST	Engage in a battle against the pirates to secure your convoy's assets.	false
cdir_events_dilemma_choice_details_localised_choice_title_rhox_torinubar_dilemma_cth_caravan_battle_1ASECOND	Relinquish some cargo, avoiding conflict and gaining temporary safety.	false
cdir_events_dilemma_choice_details_localised_choice_title_rhox_torinubar_dilemma_cth_caravan_battle_1BFIRST	Engage in combat with the corsairs, safeguarding your convoy's cargo and crew.	false
cdir_events_dilemma_choice_details_localised_choice_title_rhox_torinubar_dilemma_cth_caravan_battle_1BSECOND	Part with cargo, preserving your convoy and escaping immediate danger.	false
cdir_events_dilemma_choice_details_localised_choice_title_rhox_torinubar_dilemma_cth_caravan_battle_2AFIRST	Battle the pirates for a chance at glory and to secure your convoy's safety.	false
cdir_events_dilemma_choice_details_localised_choice_title_rhox_torinubar_dilemma_cth_caravan_battle_2ASECOND	Choose a safer route to bypass the pirate threat, although it will cost you time.	false
cdir_events_dilemma_choice_details_localised_choice_title_rhox_torinubar_dilemma_cth_caravan_battle_2BFIRST	Engage in combat, testing your convoy's strength against the pirate crew.	false
cdir_events_dilemma_choice_details_localised_choice_title_rhox_torinubar_dilemma_cth_caravan_battle_2BSECOND	Opt for safety over confrontation, but expect delays as you navigate unfamiliar waters.	false
cdir_events_dilemma_choice_details_localised_choice_title_rhox_torinubar_dilemma_cth_caravan_battle_3FIRST	Choose defiance, gearing up for battle against the pirates and protecting your crew.	false
cdir_events_dilemma_choice_details_localised_choice_title_rhox_torinubar_dilemma_cth_caravan_battle_3SECOND	Sacrifice the crew member who was an old nemesis of the pirate captain to placate the pirates and avoid hostilities.	false
