key	text	tooltip
#Loc;1;text/db/rhox_iee_lccp_effect_bundle.loc		
effect_bundles_localised_description_hkrul_sceolan_banner		false
effect_bundles_localised_description_hkrul_valbrand_banner		false
effect_bundles_localised_description_hkrul_volrik_banner		false
effect_bundles_localised_description_hkrul_zach_banner		false
effect_bundles_localised_description_rhox_valbrand_faction_trait		false
effect_bundles_localised_title_rhox_valbrand_faction_trait	Fireblade's Slavers	false
effect_bundles_localised_description_rhox_torinubar_faction_trait		false
effect_bundles_localised_title_rhox_torinubar_faction_trait	Window to the East	false
effect_bundles_localised_description_rhox_torinubar_purchase_east		false
effect_bundles_localised_title_rhox_torinubar_purchase_east	Eastern Equipment	false
effect_bundles_localised_description_rhox_torinubar_purchase_west		false
effect_bundles_localised_title_rhox_torinubar_purchase_west	Western Equipment	false
effect_bundles_localised_description_rhox_sceolan_faction_trait	Far away from the High Realm of Atylwyth, the exiled warrior Sceolan plans his definitive return to the Oak Glades.	false
effect_bundles_localised_title_rhox_sceolan_faction_trait	Exiles of Atylwyth	false
effect_bundles_localised_description_rhox_volrik_faction_trait	Volrik Clawhand, touched by Tzeentch is a Kurgan Warlord dedicated to the ultimate schemer.	false
effect_bundles_localised_title_rhox_volrik_faction_trait	The Ravenblessed	false
effect_bundles_localised_description_rhox_zach_faction_trait	Far away from the Forest of Shadows, the defeated Zacharias plots his return to the Old World where he aims to destroy all that betrayed him prior to his demise.	false
effect_bundles_localised_title_rhox_zach_faction_trait	The Everliving	false
effect_bundles_localised_description_rhox_valbrand_innate_effect_bundle	Used to set the mass bonus determined by the number of factions at war	false
effect_bundles_localised_title_rhox_valbrand_innate_effect_bundle	HIDDEN	false
effect_bundles_localised_description_rhox_volrik_cotw_hidden_effect_bundle	HIDDEN	false
effect_bundles_localised_title_rhox_volrik_cotw_hidden_effect_bundle	HIDDEN	false
effect_bundles_localised_description_rhox_volrik_wind_of_magic_high		false
effect_bundles_localised_title_rhox_volrik_wind_of_magic_high	Winds of Magic Power Reserve (80+)	false
effect_bundles_localised_description_rhox_orghotts_faction_trait		false
effect_bundles_localised_title_rhox_orghotts_faction_trait	Tide of Pestilence	false
effect_bundles_localised_description_rhox_hrothyogg_faction_trait	Pay the toll, or pay the ultimate price - Hrothyogg the Terrible.	false
effect_bundles_localised_title_rhox_hrothyogg_faction_trait	Deathtoll Tribe	false
effect_bundles_localised_description_rhox_slaurith_faction_trait	Impatiently waiting his next challenger, Lord Slaurith seeks eternal glory on the steps of Bastion Stair.	false
effect_bundles_localised_title_rhox_slaurith_faction_trait	Lord of Bastion Stair	false
effect_bundles_localised_description_rhox_burlok_faction_trait	The Master Engineer of the Engineer's Guild seeks new and undiscovered elements for his next fabrication deep within the exotic jungles of Ind.	false
effect_bundles_localised_title_rhox_burlok_faction_trait	Guildmaster of the Engineer's Guild	false
effect_bundles_localised_description_rhox_burlok_effect_bundle_burlok_artifact_part_1a	Located here is one of the Experiment ingredient that will surely bring Rhobb Grimly	false
effect_bundles_localised_title_rhox_burlok_effect_bundle_burlok_artifact_part_1a	Serpent Fang	false
effect_bundles_localised_description_rhox_burlok_effect_bundle_burlok_artifact_part_1b	Located here is one of the Experiment ingredient that will surely bring Rhobb Grimly	false
effect_bundles_localised_title_rhox_burlok_effect_bundle_burlok_artifact_part_1b	Moon Orchid	false
effect_bundles_localised_description_rhox_burlok_effect_bundle_burlok_artifact_part_2a	Located here is one of the Experiment ingredient that will surely bring Thulgrim the Thief	false
effect_bundles_localised_title_rhox_burlok_effect_bundle_burlok_artifact_part_2a	Calithian Starbloom	false
effect_bundles_localised_description_rhox_burlok_effect_bundle_burlok_artifact_part_2b	Located here is one of the Experiment ingredient that will surely bring Thulgrim the Thief	false
effect_bundles_localised_title_rhox_burlok_effect_bundle_burlok_artifact_part_2b	Sunfire Crystals	false
effect_bundles_localised_description_rhox_burlok_effect_bundle_burlok_artifact_part_3a	Located here is one of the Experiment ingredient that will surely bring Shaz Ensun	false
effect_bundles_localised_title_rhox_burlok_effect_bundle_burlok_artifact_part_3a	Aqua-Mirage Pearls	false
effect_bundles_localised_description_rhox_burlok_effect_bundle_burlok_artifact_part_3b	Located here is one of the Experiment ingredient that will surely bring Shaz Ensun	false
effect_bundles_localised_title_rhox_burlok_effect_bundle_burlok_artifact_part_3b	Khureshi Sand Opal	false
effect_bundles_localised_description_rhox_burlok_effect_bundle_burlok_artifact_part_4a	Located here is one of the Experiment ingredient for the Elixier of the Ethereal Fusion	false
effect_bundles_localised_title_rhox_burlok_effect_bundle_burlok_artifact_part_4a	Sylvan Glintleaf	false
effect_bundles_localised_description_rhox_burlok_effect_bundle_burlok_artifact_part_4b	Located here is one of the Experiment ingredient for the Elixier of the Ethereal Fusion	false
effect_bundles_localised_title_rhox_burlok_effect_bundle_burlok_artifact_part_4b	Imperial Dragonroot	false
effect_bundles_localised_description_rhox_burlok_effect_bundle_burlok_artifact_part_5a	Located here is one of the Experiment ingredient for the Elixier of the Morning Calm	false
effect_bundles_localised_title_rhox_burlok_effect_bundle_burlok_artifact_part_5a	Amanita Caesareoides	false
effect_bundles_localised_description_rhox_burlok_effect_bundle_burlok_artifact_part_5b	Located here is one of the Experiment ingredients for the Elixier of the Morning Calm	false
effect_bundles_localised_title_rhox_burlok_effect_bundle_burlok_artifact_part_5b	Ebonshade Bamboo Shoot	false
effect_bundles_localised_description_rhox_burlok_effect_bundle_burlok_artifact_part_6a	Located here is one of the Experiment ingredient for the Shimmering Leviathan Amulet	false
effect_bundles_localised_title_rhox_burlok_effect_bundle_burlok_artifact_part_6a	Leviathan Blubber	false
effect_bundles_localised_description_rhox_burlok_effect_bundle_burlok_artifact_part_6b	Located here is one of the Experiment ingredient for the Shimmering Leviathan Amulet	false
effect_bundles_localised_title_rhox_burlok_effect_bundle_burlok_artifact_part_6b	Shimmerthorn	false
effect_bundles_localised_description_rhox_burlok_effect_bundle_burlok_artifact_part_7a	Located here is one of the Experiment ingredient for the Inferno Frostplate	false
effect_bundles_localised_title_rhox_burlok_effect_bundle_burlok_artifact_part_7a	Chaosfire Emberstone	false
effect_bundles_localised_description_rhox_burlok_effect_bundle_burlok_artifact_part_7b	Located here is one of the Experiment ingredient for the Inferno Frostplate	false
effect_bundles_localised_title_rhox_burlok_effect_bundle_burlok_artifact_part_7b	Frostforged Ironclad Ore	false
effect_bundles_localised_description_rhox_burlok_effect_bundle_burlok_artifact_part_8a	Located here is one of the Experiment ingredient for the Magmaforged Granite Gauntlets	false
effect_bundles_localised_title_rhox_burlok_effect_bundle_burlok_artifact_part_8a	Magmaforged Obsidian Shard	false
effect_bundles_localised_description_rhox_burlok_effect_bundle_burlok_artifact_part_8b	Located here is one of the Experiment ingredient for the Magmaforged Granite Gauntlets	false
effect_bundles_localised_title_rhox_burlok_effect_bundle_burlok_artifact_part_8b	Karakite Granite	false
effect_bundles_localised_description_rhox_burlok_payload_artifact_4_elixir_morning_calm	With the modern technology, elixir of the far east country that harnesses the revitalizing properties is reinterpreted and now in our hands	false
effect_bundles_localised_title_rhox_burlok_payload_artifact_4_elixir_morning_calm	Elixier of the Morning Calm	false
effect_bundles_localised_description_rhox_burlok_payload_artifact_5_ethereal_fusion	Result of this experiment is a cloak that can shrouds the user in an ethereal aura. Making them nearly impossible to detect and allowing them to move through obstacles and enemies as if they were a ghost	false
effect_bundles_localised_title_rhox_burlok_payload_artifact_5_ethereal_fusion	Ethereal Fusion	false
effect_bundles_localised_description_rhox_dolmance_faction_trait	Lavish as ever, Alphonse Dolmanc√© lands with his group of cultists in the far lands of Ind, ready to plunge into excess.	false
effect_bundles_localised_title_rhox_dolmance_faction_trait	The Revellers	false
effect_bundles_localised_description_rhox_thorgar_faction_trait	On his quest to daemonic ascension, the Kurgan Zar, Thorgar the Blooded One, leads his warmongering Khazag tribe to eternal glory or inevitable demise.	false
effect_bundles_localised_title_rhox_thorgar_faction_trait	The Khazags	false
effect_bundles_localised_description_rhox_sceolan_embrace_cold	This force has recently visited the Magical Forest or Frozen climate and is receiving bonuses	false
effect_bundles_localised_title_rhox_sceolan_embrace_cold	Embrace the Cold	false
effect_bundles_localised_description_cr_far_away_forest_minister_1	Frostblade Warden	false
effect_bundles_localised_title_cr_far_away_forest_minister_1	Frostblade Warden	false
effect_bundles_localised_description_cr_far_away_forest_minister_2	Glacial Enchanter	false
effect_bundles_localised_title_cr_far_away_forest_minister_2	Glacial Enchanter	false
effect_bundles_localised_description_cr_far_away_forest_minister_3	Avalanche Steward	false
effect_bundles_localised_title_cr_far_away_forest_minister_3	Avalanche Steward	false
effect_bundles_localised_description_cr_far_away_forest_minister_4	Icebound Diplomat	false
effect_bundles_localised_title_cr_far_away_forest_minister_4	Icebound Diplomat	false
effect_bundles_localised_description_cr_far_away_forest_minister_5	Snowshroud Pathfinder	false
effect_bundles_localised_title_cr_far_away_forest_minister_5	Snowshroud Pathfinder	false
effect_bundles_localised_description_cr_far_away_forest_minister_6	Glacial Lorekeeper	false
effect_bundles_localised_title_cr_far_away_forest_minister_6	Glacial Lorekeeper	false
effect_bundles_localised_description_rhox_sceolan_cathay_punished	Dragon Emperor is just a newt	false
effect_bundles_localised_title_rhox_sceolan_cathay_punished	Cathay Punished	false
effect_bundles_localised_description_rhox_sceolan_cathay_spared	They're foolish enough to serve a lizard as a god. Spare them	false
effect_bundles_localised_title_rhox_sceolan_cathay_spared	Cathay Spared	false
effect_bundles_localised_description_rhox_arbaal_faction_trait	''More battle, more feats, more victories, more skulls!'' - Arbaal the Destroyer of Khorne	false
effect_bundles_localised_title_rhox_arbaal_faction_trait	The Undefeated	false
effect_bundles_localised_description_rhox_slaurith_reward_1	Knight Hunted Down 1	false
effect_bundles_localised_title_rhox_slaurith_reward_1	Knight Hunted Down 1	false
effect_bundles_localised_description_rhox_slaurith_reward_2	Knight Hunted Down 2	false
effect_bundles_localised_title_rhox_slaurith_reward_2	Knight Hunted Down 2	false
effect_bundles_localised_description_rhox_slaurith_reward_3	Knight Hunted Down 3	false
effect_bundles_localised_title_rhox_slaurith_reward_3	Knight Hunted Down 3	false
effect_bundles_localised_description_rhox_slaurith_reward_4	Knight Hunted Down 4	false
effect_bundles_localised_title_rhox_slaurith_reward_4	Knight Hunted Down 4	false
effect_bundles_localised_description_rhox_slaurith_reward_5	Knight Hunted Down 5	false
effect_bundles_localised_title_rhox_slaurith_reward_5	Knight Hunted Down 5	false
effect_bundles_localised_description_rhox_slaurith_reward_6	Knight Hunted Down 6	false
effect_bundles_localised_title_rhox_slaurith_reward_6	Knight Hunted Down 6	false
effect_bundles_localised_description_rhox_slaurith_reward_7	Knight Hunted Down 7	false
effect_bundles_localised_title_rhox_slaurith_reward_7	Knight Hunted Down 7	false
effect_bundles_localised_description_rhox_slaurith_reward_8	Knight Hunted Down 8	false
effect_bundles_localised_title_rhox_slaurith_reward_8	Knight Hunted Down 8	false
effect_bundles_localised_description_rhox_engra_faction_trait	Server of not one, but three Everchosen. Engra Deathsword is the very catalyst of the End Times, wading through the steppes and wastes in search of potential armies and warlords to do the Everchosen's bidding.	false
effect_bundles_localised_title_rhox_engra_faction_trait	The Everchosen's Headhunter	false
effect_bundles_localised_description_rhox_vroth_faction_trait	Surtha Lenk leads his band of Tokmars hunters as they attempt to unite the Kurgan tribes, be it monster - beast or man.	false
effect_bundles_localised_title_rhox_vroth_faction_trait	Revered Tokmars	false
effect_bundles_localised_description_rhox_karitamen_faction_trait	Karitamen has landed with his band of cultists to serve in the ultimate plot of Ptra.	false
effect_bundles_localised_title_rhox_karitamen_faction_trait	The Liche Lord	false
effect_bundles_localised_description_rhox_engra_campaign_progress_opeation_set_1		false
effect_bundles_localised_title_rhox_engra_campaign_progress_opeation_set_1	Archaon Hungry	false
effect_bundles_localised_description_rhox_engra_campaign_progress_opeation_set_2		false
effect_bundles_localised_title_rhox_engra_campaign_progress_opeation_set_2	Archaon Eating	false
effect_bundles_localised_description_rhox_engra_campaign_progress_opeation_set_3		false
effect_bundles_localised_title_rhox_engra_campaign_progress_opeation_set_3	Archaon Full	false
effect_bundles_localised_description_rhox_engra_engra_support	Archaon recieves the following bonusses following Engra's efforts	false
effect_bundles_localised_title_rhox_engra_engra_support	Engra's Support	false
effect_bundles_localised_description_rhox_arbaal_resource_effects_1	You're a disgrace	false
effect_bundles_localised_title_rhox_arbaal_resource_effects_1	Disgrace of Khorne	false
effect_bundles_localised_description_rhox_arbaal_resource_effects_2	Everyday, another Khorne	false
effect_bundles_localised_title_rhox_arbaal_resource_effects_2	Minon of Khorne	false
effect_bundles_localised_description_rhox_arbaal_resource_effects_3	Somebody knows you	false
effect_bundles_localised_title_rhox_arbaal_resource_effects_3	Champion of Khorne	false
effect_bundles_localised_description_rhox_arbaal_resource_effects_4	I'm the Destroyer!	false
effect_bundles_localised_title_rhox_arbaal_resource_effects_4	Destroyer of Khorne	false
effect_bundles_localised_description_rhox_arbaal_other_faction_curse	You're a disgrace	false
effect_bundles_localised_title_rhox_arbaal_other_faction_curse	Disgrace of Khorne	false
effect_bundles_localised_description_rhox_duriath_faction_trait	Duriath Helbane	false
effect_bundles_localised_title_rhox_duriath_faction_trait	Duriath Helbane	false
effect_bundles_localised_description_rhox_burlok_payload_artifact_1_ritual_dummy	Inspired by your milestone, Rhobb Grimly will join you	false
effect_bundles_localised_title_rhox_burlok_payload_artifact_1_ritual_dummy	Rhobb Grimly	false
effect_bundles_localised_description_rhox_burlok_payload_artifact_2_ritual_dummy	Inspired by your milestone, Thulgrim the Thief will join you	false
effect_bundles_localised_title_rhox_burlok_payload_artifact_2_ritual_dummy	Thulgrim the Thief	false
effect_bundles_localised_description_rhox_burlok_payload_artifact_3_ritual_dummy	Inspired by your milestone, Shaz Ensun will join you	false
effect_bundles_localised_title_rhox_burlok_payload_artifact_3_ritual_dummy	Shaz Ensun	false
effect_bundles_localised_description_wh3_main_books_of_nagash_zach_reward_1		false
effect_bundles_localised_description_wh3_main_books_of_nagash_zach_reward_2		false
effect_bundles_localised_description_wh3_main_books_of_nagash_zach_reward_3		false
effect_bundles_localised_description_wh3_main_books_of_nagash_zach_reward_3_army		false
effect_bundles_localised_description_wh3_main_books_of_nagash_zach_reward_4		false
effect_bundles_localised_description_wh3_main_books_of_nagash_zach_reward_5		false
effect_bundles_localised_description_wh3_main_books_of_nagash_zach_reward_6		false
effect_bundles_localised_description_wh3_main_books_of_nagash_zach_reward_7		false
effect_bundles_localised_description_wh3_main_books_of_nagash_zach_reward_8		false
effect_bundles_localised_title_wh3_main_books_of_nagash_zach_reward_1	First Book of Nagash	false
effect_bundles_localised_title_wh3_main_books_of_nagash_zach_reward_2	Second Book of Nagash	false
effect_bundles_localised_title_wh3_main_books_of_nagash_zach_reward_3	Third Book of Nagash	false
effect_bundles_localised_title_wh3_main_books_of_nagash_zach_reward_3_army	Third Book of Nagash	false
effect_bundles_localised_title_wh3_main_books_of_nagash_zach_reward_4	Fourth Book of Nagash	false
effect_bundles_localised_title_wh3_main_books_of_nagash_zach_reward_5	Fifth Book of Nagash	false
effect_bundles_localised_title_wh3_main_books_of_nagash_zach_reward_6	Sixth Book of Nagash	false
effect_bundles_localised_title_wh3_main_books_of_nagash_zach_reward_7	Seventh Book of Nagash	false
effect_bundles_localised_title_wh3_main_books_of_nagash_zach_reward_8	Eighth Book of Nagash	false
effect_bundles_localised_description_wh3_main_books_of_nagash_zach_studied_reward_1		false
effect_bundles_localised_description_wh3_main_books_of_nagash_zach_studied_reward_2		false
effect_bundles_localised_description_wh3_main_books_of_nagash_zach_studied_reward_3		false
effect_bundles_localised_description_wh3_main_books_of_nagash_zach_studied_reward_3_army		false
effect_bundles_localised_description_wh3_main_books_of_nagash_zach_studied_reward_4		false
effect_bundles_localised_description_wh3_main_books_of_nagash_zach_studied_reward_5		false
effect_bundles_localised_description_wh3_main_books_of_nagash_zach_studied_reward_6		false
effect_bundles_localised_description_wh3_main_books_of_nagash_zach_studied_reward_7		false
effect_bundles_localised_description_wh3_main_books_of_nagash_zach_studied_reward_8		false
effect_bundles_localised_title_wh3_main_books_of_nagash_zach_studied_reward_1	First Book of Nagash	false
effect_bundles_localised_title_wh3_main_books_of_nagash_zach_studied_reward_2	Second Book of Nagash	false
effect_bundles_localised_title_wh3_main_books_of_nagash_zach_studied_reward_3	Third Book of Nagash	false
effect_bundles_localised_title_wh3_main_books_of_nagash_zach_studied_reward_3_army	Third Book of Nagash	false
effect_bundles_localised_title_wh3_main_books_of_nagash_zach_studied_reward_4	Fourth Book of Nagash	false
effect_bundles_localised_title_wh3_main_books_of_nagash_zach_studied_reward_5	Fifth Book of Nagash	false
effect_bundles_localised_title_wh3_main_books_of_nagash_zach_studied_reward_6	Sixth Book of Nagash	false
effect_bundles_localised_title_wh3_main_books_of_nagash_zach_studied_reward_7	Seventh Book of Nagash	false
effect_bundles_localised_title_wh3_main_books_of_nagash_zach_studied_reward_8	Eighth Book of Nagash	false
effect_bundles_localised_description_rhox_karitamen_hidden_effect_bundle		false
effect_bundles_localised_title_rhox_karitamen_hidden_effect_bundle	Hidden	false
effect_bundles_localised_description_rhox_beorg_faction_trait	At the edge of the frozen Fjord's of Urs towers the Halls of Urslo, home of ravaging marauding Bearstrikken norsemen.	false
effect_bundles_localised_title_rhox_beorg_faction_trait	The Ursfjordings	false
effect_bundles_localised_description_rhox_valbrand_slave_effect_1	As higher the slave population goes, the more money Valbrand can make out	false
effect_bundles_localised_description_rhox_valbrand_slave_effect_2	As higher the slave population goes, the more money Valbrand can make out	false
effect_bundles_localised_description_rhox_valbrand_slave_effect_3	As higher the slave population goes, the more money Valbrand can make out	false
effect_bundles_localised_description_rhox_valbrand_slave_effect_4	As higher the slave population goes, the more money Valbrand can make out	false
effect_bundles_localised_description_rhox_valbrand_slave_effect_5	As higher the slave population goes, the more money Valbrand can make out	false
effect_bundles_localised_title_rhox_valbrand_slave_effect_1	Slave Population: Low [0-800]	false
effect_bundles_localised_title_rhox_valbrand_slave_effect_2	Slave Population: Stable [801-2000]	false
effect_bundles_localised_title_rhox_valbrand_slave_effect_3	Slave Population: High [2001-5000]	false
effect_bundles_localised_title_rhox_valbrand_slave_effect_4	Slave Population: Very High [5001-10000]	false
effect_bundles_localised_title_rhox_valbrand_slave_effect_5	Slave Population: Abundant [10000+]	false
effect_bundles_localised_description_rhox_valbrand_settle	Sets up a defensive camp, allowing for building construction, recruitment and replenishment, regardless of territory.	false
effect_bundles_localised_title_rhox_valbrand_settle	Stance: Encamp	false
effect_bundles_localised_description_rhox_arbaal_hidden_first_turn	Hiddne only for first turn so he can reach the settlement	false
effect_bundles_localised_title_rhox_arbaal_hidden_first_turn	Hiddne only for first turn so he can reach the settlement	false
